agir == to act
aimer == to like
ajouter == to add
aller == to go
apercevoir == to catch sight of, to notice
appeler == to call
apporter == to bring (something)
apprendre == to learn
arriver == to arrive
arrêter == to stop
attendre == to wait
avoir == to have
boire == to drink
cacher == to hide
causer == to cause
changer == to change
chercher == to look for
commencer == to begin
comprendre == to understand
compter == to count
conduire == to drive
connaître == to know
continuer == to continue
coucher == to have sex with
courir == to run
crier == to shout
croire == to believe
demander == to ask
demeurer == to remain
descendre == to go down
devenir == to become
devoir == to have to
dire == to say
donner == to give
dormir == to sleep
entendre == to hear
entrer == to enter
envoyer == to send
essayer == to try
exister == to exist
expliquer == to explain
faire == to do
falloir == to have to
finir == to finish
frapper == to hit
garder == to keep
jeter == to throw
jouer == to play
lever == to raise
lire == to read
manger == to eat
manquer == to miss
marcher == to walk
mettre == to put
monter == to go up
montrer == to show
mourir == to die
nommer == to call
obtenir == to get
occuper == to occupy
offrir == to offer
oublier == to forget
ouvrir == to open
paraître == to appear
parler == to speak
partir == to leave
passer == to pass
payer == to pay
penser == to think
perdre == to lose
permettre == to allow
pleurer ==  to mourn, to cry, to weep
porter == to wear
poser == to put
pousser == to push
pouvoir == to be able to
prendre == to take
présenter == to present
quitter == to leave (depart)
raconter == to tell
rappeler == to call back
recevoir == to receive
reconnaître == to recognize
regarder == to look
remettre == to put back, to lay, to put
rencontrer == to meet
rendre == to return
reprendre == to resume
rester == to stay
retourner == to return
retrouver == to find (again)
revenir == to come back
rire == to laugh
répondre == to answer
répéter == to repeat
s'asseoir == to sit
saisir == to seize
savoir == to know
sembler == to seem
sentir == to feel
serrer == to tighten
servir == to serve
songer == to daydream, to think, to dream
sortir == to go out
sourire == to smile
suivre == to follow
tenir == to hold
tirer == to pull
tomber == to fall
tourner == to turn
travailler == to work
trouver == to find
tuer == to kill
venir == to come
vivre == to live
voir == to see
vouloir == to want
écouter == to listen to
écrire == to write
être == to be
