abandonner == to give up (not renoncer)
abattre == to slaughter
abolir == to abolish
accepter == to accept
accomplir == to fulfil, to accomplish
accorder == to grant
accuser == to accuse
acheter == to buy
achever == to complete
admettre == to admit
admirer == to admire
adorer == to adore
adresser == to address
affirmer == to affirm
agacer == to annoy
agir == to act
agiter == to shake
aider == to help
aimer == to like
ajouter == to add
aller == to go
allumer == to turn on
amener == to bring (someone)
amuser == to amuse
animer == to bring life to
annoncer == to announce
apercevoir == to catch sight of, to notice
apparaître == to appear
appartenir == to belong
appeler == to call
apporter == to bring (something)
apprendre == to learn
approcher == to approach
appuyer == to press
arriver == to arrive
arrêter == to stop
assister == to assist
assurer == to insure
attacher == to attach
attaquer == to attack
atteindre == to reach
attendre == to wait
attirer == to attract
avancer == to advance
avoir == to have
avouer == to admit
baisser == to lower
battre == to beat
boire == to drink
briller == to shine
briser == to break
brûler == to burn
cacher == to hide
calmer == to calm down
casser == to break
causer == to cause
cesser == to cease
changer == to change
chanter == to sing
charger == to load
chasser == to hunt
chercher == to look for
choisir == to choose
commander == to order, to command, to commission
commencer == to begin
comparer == to compare
composer == to compose
comprendre == to understand
compter == to count
conclure == to conclude
condamner == to condemn
conduire == to drive
confier == to entrust
connaître == to know
conquérir == to conquer
consentir == to consent
considérer == to consider
construire == to build
consulter == to consult
contenir == to contain
contenter == to satisfy
continuer == to continue
coucher == to have sex with
couler == to flow
couper == to cut
courir == to run
couvrir == to cover
craindre == to fear
creuser == to dig
crier == to shout
croire == to believe
créer == to create
danser == to dance
demander == to ask
demeurer == to remain
descendre == to go down
dessiner == to draw
devenir == to become
deviner == to guess
devoir == to have to
diminuer == to diminish
dire == to say
diriger == to lead
discuter == to discuss
disparaître == to disappear
disposer == to arrange (not arranger)
distinguer == to distinguish
dominer == to dominate
donner == to give
dormir == to sleep
douter == to doubt
dresser == to draw up
durer == to last
déchirer == to tear
décider == to decide
déclarer == to declare
découvrir == to discover
décrire == to describe
défaire == to undo
défendre == to defend
déjeuner == to lunch
démolir == to demolish
dépasser == to exceed
déposer == to deposit
désirer == to desire
désobéir == to disobey
détruire == to destroy
dîner == to dine
effacer == to erase
embrasser == to kiss
emmener == to take along
employer == to employ
emporter == to take, to carry away
empêcher == to prevent
endormir == to put to sleep
enfermer == to lock up
enfoncer == to break in, to push in, to drive in
engager == to hire
enlever == to remove
enregistrer == to record
entendre == to hear
enterrer == to bury
entourer == to surround
entraîner == to train, to involve
entrer == to enter
envelopper == to wrap
envoyer == to send
espérer == to hope
essayer == to try
examiner == to examine
exiger == to require
exister == to exist
expliquer == to explain
exposer == to display
exprimer == to express
exécuter == to execute
faire == to do
falloir == to have to
fatiguer == to tire
fermer == to close
figurer == to appear (intr) / to represent, to show, to depict (tran) / to be an extra, to do a walk-on part
finir == to finish
fixer == to fix
fonder == to found
forcer == to force
former == to form
franchir == to get over
frapper == to hit
fuir == to flee, to escape, to avoid
fumer == to smoke
gagner == to win
garder == to keep
glisser == to slide
grandir == to grow
grimper == to climb
habiller == to dress
habiter == to live in
haïr == to hate
hésiter == to hesitate
ignorer == to ignore
imaginer == to imagine
importer == to import
imposer == to impose
indiquer == to indicate
inquiéter == to worry
inspirer == to inspire
installer == to install
interroger == to question
interrompre == to interrupt
introduire == to introduce
intéresser == to interest
inventer == to invent
inviter == to invite
jeter == to throw
jouer == to play
jouir == to enjoy
juger == to judge
jurer == to swear
lancer == to throw
laver == to wash
lever == to raise
lier == to link
lire == to read
livrer == to deliver
lutter == to struggle (not se battre)
maintenir == to maintain
manger == to eat
manquer == to miss
marcher == to walk
marquer == to mark
menacer == to threaten
mener == to lead
mentir == to lie
mettre == to put
monter == to go up
montrer == to show
mourir == to die
mériter == to deserve
mêler == to mingle
nager == to swim
naviguer == to navigate
naître == to be born
nommer == to call
nourrir == to feed
obliger == to force
observer == to observe
obtenir == to get
obéir == to obey
occuper == to occupy
offrir == to offer
oser == to dare
oublier == to forget
ouvrir == to open
paraître == to appear
parcourir == to travel all over
parler == to speak
partager == to share
partir == to leave
parvenir == to reach
passer == to pass
payer == to pay
pencher == to tilt
pendre == to hang, to dangle
penser == to think
perdre == to lose
permettre == to allow
peser == to weigh
placer == to place
plaindre == to pity
plaire == to please
pleurer ==  to mourn, to cry, to weep
pleuvoir == to rain
plonger == to dive
porter == to wear
poser == to put
posséder == to own
poursuivre == to pursue
pousser == to push
pouvoir == to be able to
prendre == to take
presser == to squeeze
prier == to pray
produire == to produce
profiter == to take advantage
promener == to go for a walk
promettre == to promise
prononcer == to pronounce
proposer == to propose
protéger == to protect
prouver == to prove
précipiter == to hasten
préférer == to prefer
préparer == to prepare
présenter == to present
prétendre == to claim, to pretend
prévenir == to prevent
prévoir == to foresee
prêter == to lend
pénétrer == to penetrate
quitter == to leave (depart)
raconter == to tell
ramasser == to pick up
rappeler == to call back
rapporter == to bring back, to bring
rassurer == to reassure
recevoir == to receive
recommencer == to start again
reconnaître == to recognize
reconstruire == to rebuild
reculer == to move back
refaire == to redo
refuser == to refuse
regarder == to look
regretter == to regret
rejeter == to reject
rejoindre == to meet (up with), to join, to catch up with
remarquer == to notice
remercier == to thank
remettre == to put back, to lay, to put
remonter == to go back up
remplacer == to replace
remplir == to fill
rencontrer == to meet
rendre == to return
renoncer == to give up
renverser == to knock down
reposer == to rest
repousser == to push away
reprendre == to resume
représenter == to represent
respecter == to respect
respirer == to breathe
ressembler == to look like
rester == to stay
retenir == to retain
retirer == to remove, to take off
retomber == to fall again
retourner == to return
retrouver == to find (again)
revenir == to come back
revoir == to see again
rire == to laugh
risquer == to risk
rompre == to break
rouler == to roll
réclamer == to ask for
réduire == to reduce
réfléchir == to reflect [thoughts]
répandre == to spread, to scatter, to spill
répondre == to answer
répéter == to repeat
résister == to resist
résoudre == to solve
réunir == to gather
réussir == to succeed
révéler == to reveal
rêver == to dream
s'asseoir == to sit
saisir == to seize
saluer == to greet
satisfaire == to satisfy
sauter == to jump
sauver == to rescue
savoir == to know
se fâcher == to get angry
se marier == to get married
se réveiller == to wake up
se souvenir == to remember
sembler == to seem
sentir == to feel
serrer == to tighten
servir == to serve
signer == to sign
signifier == to mean
songer == to daydream, to think, to dream
sonner == to ring
sortir == to go out
souffler == to blow
souffrir == to suffer
souhaiter == to wish
soulever == to lift up, to arouse, to raise
soumettre == to submit
sourire == to smile
soutenir == to sustain
subir == to undergo
suggérer == to suggest
suivre == to follow
supporter == to support
supposer == to suppose
surprendre == to surprise
séparer == to separate
tenir == to hold
tenter == to tempt
terminer == to finish
tirer == to pull
tomber == to fall
toucher == to touch
tourner == to turn
trahir == to betray
traiter == to treat
transformer == to transform
travailler == to work
traverser == to cross
trembler == to shiver
tromper == to deceive, to cheat on
trouver == to find
tuer == to kill
user == to wear out
utiliser == to use
vaincre == to defeat
valoir == to be worth
veiller == to watch over
vendre == to sell
venir == to come
verser == to pour
vivre == to live
voir == to see
voler == to steal
vouloir == to want
voyager == to travel
vérifier == to check
vêtir == to clothe
échapper == to escape
éclairer == to light up, to clarify, to enlighten
éclater == to burst
écouter == to listen to
écraser == to crush
écrire == to write
élever == to raise
élire == to elect
éloigner == to move away
éprouver == to feel
établir == to establish
éteindre == to put out
étendre == to stretch
étonner == to astonish
étouffer == to suffocate
étudier == to study
éviter == to avoid
être == to be
divorcer == to get divorced
corriger == to correct
célébrer == to celebrate
bavarder == to chat
avoir besoin de == to need
augmenter == to increase
blâmer == to blame
avoir raison == to be right
conseiller == to advise
consommer == to consume
dénoncer == to denounce
échouer == to fail
imprimer == to print
encourager == to encourage
geler == to freeze
goûter == to taste
guérir == to cure
informer == to inform
insister == to insist
ralentir == to slow down
redire == to repeat
détester == to hate
négocier == to negotiate
enseigner == to teach
détenir == to hold, to detain
attraper == to catch
contrôler == to control
convaincre == to convince
mesurer == to measure
mouiller == to get something wet
